1 10 8
##########
#.      .#
#  O  O  #
#. O    C#
#    1   #
#  O# O  #
#.  #   .#
##########
2 5 5
#####
#1  #
# O #
#  .#
#####
3 8 8
########
 .    .#
      ##
   # ###
     ###
###  ###
1 #OO###
     ###
4 8 8
########
#     .#
#  O   #
## ##  #
## #####
#   1 ##
#   O ##
# . ####
