13 14
#############
#A          #
# # ## ###. #
# #         #
# # #### #  #
# # #  # ## #
# # #     # #
# # # #   # #
#   #   # # #
# # ##  # # #
# o     # # #
# #### ## # #
#           #
#############