10 10
##########
#        #
#  ### # #
##o      #
## ### ###
## #.A   #
#  ####  #
#        #
#        #
##########